agency,year,state,population,ORI,total_officers,female_employees_officers,male_employees_officers,total_civilians,female_employees_civilians,male_employees_civilians,officers_killed_accident,officers_killed_felony,assault_injury_total,assault_injury_gun,assault_injury_knife,assault_injury_hand_feet,assault_injury_other,assault_no_injury_total,assault_no_injury_gun,assault_no_injury_knife,assault_no_injury_hand_feet,assault_no_injury_other,total_assault_total,total_assault_gun,total_assault_knife,total_assault_hand_feet,total_assault_other,all_oth_total_assault,ambush_total_assault,att_oth_arrest_total_assault,burglary_total_assault,civil_disorder_total_assault,cust_prisoners_total_assault,deranged_total_assault,disturbance_total_assault,robbery_total_assault,susp_pers_total_assault,traffic_total_assault
Chino Police Department,1975,California,26641,CA03602,33,1,32,15,12,3,0,0,11,0,0,8,3,8,0,0,8,0,19,0,0,16,3,0,0,1,0,5,2,0,7,0,2,2
Chino Police Department,1976,California,28300,CA03602,36,1,35,20,15,5,0,0,26,0,0,11,15,5,0,0,5,0,31,0,0,16,15,3,0,9,0,5,0,0,5,0,4,5
Chino Police Department,1977,California,28847,CA03602,39,2,37,15,9,6,0,0,9,0,0,8,1,18,3,0,9,6,27,3,0,17,7,4,4,3,1,0,2,0,6,0,1,6
Chino Police Department,1978,California,33246,CA03602,52,0,52,17,14,3,0,0,14,1,0,8,5,17,3,0,10,4,31,4,0,18,9,5,7,7,0,0,4,0,7,0,1,0
Chino Police Department,1979,California,35792,CA03602,49,1,48,12,9,3,0,0,13,0,1,6,6,11,2,1,4,4,24,2,2,10,10,3,0,1,1,0,2,0,4,0,4,9
Chino Police Department,1980,California,40018,CA03602,49,1,48,10,9,1,0,0,3,0,0,3,0,11,1,0,10,0,14,1,0,13,0,0,0,1,0,0,3,0,5,0,3,2
Chino Police Department,1981,California,41083,CA03602,55,2,53,16,14,2,0,0,7,0,0,6,1,13,0,0,10,3,20,0,0,16,4,0,0,2,0,0,2,0,7,1,3,5
Chino Police Department,1982,California,42044,CA03602,57,2,55,18,14,4,0,0,0,0,0,0,0,9,0,0,8,1,9,0,0,8,1,1,0,1,0,0,2,0,3,0,2,0
Chino Police Department,1983,California,42809,CA03602,58,2,56,18,15,3,0,0,0,0,0,0,0,3,0,0,3,0,3,0,0,3,0,1,0,0,0,0,0,0,2,0,0,0
Chino Police Department,1984,California,44658,CA03602,58,2,56,20,16,4,0,0,8,0,0,7,1,11,0,0,11,0,19,0,0,18,1,0,0,0,0,0,3,0,8,2,3,3
Chino Police Department,1986,California,49268,CA03602,68,0,68,26,22,4,0,0,1,0,0,1,0,10,0,0,10,0,11,0,0,11,0,1,0,1,1,0,5,0,2,0,1,0
Chino Police Department,1987,California,52115,CA03602,76,1,75,27,22,5,0,0,5,0,0,4,1,0,0,0,0,0,5,0,0,4,1,1,0,0,0,0,0,0,3,0,1,0
Chino Police Department,1988,California,54717,CA03602,75,1,74,31,25,6,0,0,6,0,0,6,0,15,5,1,9,0,21,5,1,15,0,0,0,0,0,1,2,0,11,0,2,5
Chino Police Department,1989,California,59710,CA03602,77,1,76,28,22,6,0,0,2,0,0,2,0,19,0,2,14,3,21,0,2,16,3,2,0,1,0,0,1,0,16,0,1,0
Chino Police Department,1990,California,59682,CA03602,79,1,78,33,27,6,0,0,2,0,0,2,0,10,0,1,7,2,12,0,1,9,2,0,0,3,0,0,0,0,9,0,0,0
Chino Police Department,1991,California,60925,CA03602,80,2,78,43,36,7,0,0,2,0,1,1,0,2,0,0,2,0,4,0,1,3,0,0,1,0,2,0,0,0,1,0,0,0
Chino Police Department,1992,California,61901,CA03602,78,3,75,58,46,12,0,0,7,0,1,6,0,8,0,0,15,2,15,0,1,12,2,0,1,0,2,0,0,4,3,0,0,5
Chino Police Department,1993,California,63863,CA03602,78,3,75,34,26,8,0,0,0,0,0,0,0,3,0,0,3,0,3,0,0,3,0,0,0,0,0,0,0,0,3,0,0,0
Chino Police Department,1994,California,64313,CA03602,79,3,76,42,36,6,0,0,2,0,0,2,0,4,0,0,4,0,6,0,0,6,0,0,0,0,0,0,0,0,5,0,0,1
Chino Police Department,1995,California,65106,CA03602,79,2,77,36,30,6,0,0,1,0,0,1,0,4,0,0,0,4,5,0,0,1,4,0,0,0,1,0,0,1,2,0,1,0
Chino Police Department,1996,California,65701,CA03602,74,3,71,23,21,2,0,0,3,0,0,3,0,3,0,0,3,0,6,0,0,6,0,0,0,0,0,0,0,1,2,0,2,1
Chino Police Department,1997,California,66504,CA03602,79,2,77,24,21,3,0,0,0,0,0,0,0,0,0,0,0,0,0,0,0,0,0,0,0,0,0,0,0,0,0,0,0,0
Chino Police Department,1998,California,66396,CA03602,79,4,75,30,25,5,0,0,0,0,0,0,0,0,0,0,0,0,0,0,0,0,0,0,0,0,0,0,0,0,0,0,0,0
Chino Police Department,1999,California,66729,CA03602,79,4,75,31,26,5,0,0,0,0,0,0,0,0,0,0,0,0,0,0,0,0,0,0,0,0,0,0,0,0,0,0,0,0
Chino Police Department,2000,California,67168,CA03602,83,6,77,30,28,2,1,0,3,0,0,3,0,5,0,0,3,2,8,0,0,6,2,0,0,2,0,0,1,0,3,0,0,2
Chino Police Department,2001,California,68416,CA03602,86,7,79,33,32,1,0,0,2,0,0,0,2,4,0,1,2,1,6,0,1,2,3,0,0,1,0,0,0,0,3,0,0,2
Chino Police Department,2002,California,69635,CA03602,91,8,83,28,28,0,0,0,5,0,0,3,2,8,0,0,8,0,13,0,0,11,2,2,0,4,0,0,1,0,6,0,0,0
Chino Police Department,2003,California,70695,CA03602,92,7,85,31,31,0,0,0,3,0,0,3,0,11,3,1,6,1,14,3,1,9,1,4,0,6,0,0,0,0,1,0,1,2
Chino Police Department,2004,California,72758,CA03602,93,9,84,33,33,0,0,0,3,0,0,3,0,13,0,0,10,3,16,0,0,13,3,5,0,5,3,0,2,0,0,0,0,1
Chino Police Department,2006,California,78277,CA03602,95,10,85,48,45,3,0,0,8,0,0,8,0,6,0,0,3,3,14,0,0,11,3,3,0,2,0,0,0,0,5,0,2,2
Chino Police Department,2007,California,80699,CA03602,99,10,89,47,44,3,0,0,3,0,0,3,0,11,0,0,8,3,14,0,0,11,3,4,0,2,1,0,0,0,3,0,1,3
Chino Police Department,2008,California,84595,CA03602,97,10,87,49,46,3,0,0,8,0,0,5,3,9,0,0,9,0,17,0,0,14,3,1,0,9,0,0,0,0,3,0,1,3
Chino Police Department,2009,California,84626,CA03602,97,12,85,49,46,3,0,0,6,1,0,5,0,1,0,0,1,0,7,1,0,6,0,0,0,0,0,0,0,0,5,1,1,0
Chino Police Department,2010,California,77983,CA03602,102,8,94,48,45,3,0,0,10,0,0,9,1,2,0,0,1,1,12,0,0,10,2,0,0,2,0,0,3,0,3,0,1,3
Chino Police Department,2011,California,78900,CA03602,102,8,94,51,46,5,0,0,4,0,0,4,0,3,0,0,3,0,7,0,0,7,0,0,0,0,0,0,1,1,5,0,0,0
Chino Police Department,2012,California,79792,CA03602,102,6,96,51,47,4,0,0,4,1,0,3,0,31,0,0,31,0,35,1,0,34,0,3,0,2,0,0,0,3,18,3,2,4
Chino Police Department,2013,California,80704,CA03602,92,5,87,50,47,3,0,0,5,0,0,5,0,33,0,0,29,4,38,0,0,34,4,12,0,1,1,0,0,0,9,2,11,2
Chino Police Department,2014,California,81600,CA03602,98,3,95,50,47,3,0,0,3,0,0,3,0,12,0,0,11,1,15,0,0,14,1,2,0,0,0,0,0,0,6,0,6,1
Chino Police Department,2015,California,86344,CA03602,105,6,99,50,45,5,0,0,21,0,0,21,0,17,0,0,17,0,38,0,0,38,0,3,0,8,1,0,1,5,8,1,8,3
