agency,year,state,population,ORI,total_officers,female_employees_officers,male_employees_officers,total_civilians,female_employees_civilians,male_employees_civilians,officers_killed_accident,officers_killed_felony,assault_injury_total,assault_injury_gun,assault_injury_knife,assault_injury_hand_feet,assault_injury_other,assault_no_injury_total,assault_no_injury_gun,assault_no_injury_knife,assault_no_injury_hand_feet,assault_no_injury_other,total_assault_total,total_assault_gun,total_assault_knife,total_assault_hand_feet,total_assault_other,all_oth_total_assault,ambush_total_assault,att_oth_arrest_total_assault,burglary_total_assault,civil_disorder_total_assault,cust_prisoners_total_assault,deranged_total_assault,disturbance_total_assault,robbery_total_assault,susp_pers_total_assault,traffic_total_assault
Miami Beach Police Department,1975,Florida,89025,FL01307,248,4,244,85,41,44,0,0,11,1,0,10,0,58,3,1,53,1,69,4,1,63,1,1,0,6,2,2,5,1,19,2,23,8
Miami Beach Police Department,1976,Florida,87492,FL01307,242,5,237,67,50,17,0,0,0,0,0,0,0,0,0,0,0,0,0,0,0,0,0,0,0,0,0,0,0,0,0,0,0,0
Miami Beach Police Department,1977,Florida,86376,FL01307,210,4,206,80,41,39,0,0,1,0,0,1,0,1,0,0,1,0,2,0,0,2,0,0,0,2,0,0,0,0,0,0,0,0
Miami Beach Police Department,1978,Florida,86813,FL01307,213,10,203,66,39,27,0,0,3,0,0,3,0,5,0,4,1,0,8,0,4,4,0,1,0,0,0,0,0,0,3,2,1,1
Miami Beach Police Department,1979,Florida,91992,FL01307,213,15,198,66,36,30,0,0,7,0,0,2,5,10,6,1,2,1,17,6,1,4,6,0,0,0,0,0,2,0,2,12,0,1
Miami Beach Police Department,1980,Florida,90836,FL01307,245,25,220,65,36,29,0,0,8,0,0,3,5,0,0,0,0,0,8,0,0,3,5,0,0,0,0,0,0,0,3,2,0,3
Miami Beach Police Department,1981,Florida,96522,FL01307,268,23,245,86,53,33,0,0,1,1,0,0,0,26,1,0,21,4,27,2,0,21,4,1,0,12,1,1,0,0,6,0,1,5
Miami Beach Police Department,1982,Florida,98896,FL01307,282,24,258,155,60,95,0,0,2,0,0,2,0,19,0,1,15,3,21,0,1,17,3,3,0,4,0,0,0,0,10,1,1,2
Miami Beach Police Department,1983,Florida,101402,FL01307,287,23,264,99,66,33,0,0,1,0,0,0,1,13,3,1,5,4,14,3,1,5,5,3,0,5,1,0,1,0,1,0,2,1
Miami Beach Police Department,1984,Florida,98089,FL01307,297,21,276,99,61,38,0,1,9,1,1,5,2,9,1,0,5,3,18,2,1,10,5,1,0,2,0,0,2,0,8,3,2,0
Miami Beach Police Department,1985,Florida,101579,FL01307,285,23,262,90,58,32,0,0,7,0,0,6,1,14,1,2,10,1,21,1,2,16,2,0,0,2,1,0,4,0,12,1,1,0
Miami Beach Police Department,1986,Florida,101902,FL01307,283,23,260,87,62,25,0,0,3,0,0,3,0,8,1,1,3,3,11,1,1,6,3,0,0,0,1,0,1,0,7,0,1,1
Miami Beach Police Department,1987,Florida,97833,FL01307,289,23,266,130,73,57,0,0,14,0,0,12,2,10,1,2,6,1,24,1,2,18,3,1,0,6,0,1,0,0,10,0,3,3
Miami Beach Police Department,1990,Florida,92639,FL01307,321,26,295,135,90,45,0,0,89,3,4,70,12,32,4,3,12,13,121,7,7,82,25,20,0,6,4,0,10,0,35,0,30,16
Miami Beach Police Department,1991,Florida,95067,FL01307,315,26,289,142,91,51,0,0,76,0,1,61,14,53,5,4,35,9,129,5,5,96,23,7,0,9,2,0,18,0,60,0,24,9
Miami Beach Police Department,1992,Florida,96577,FL01307,301,26,275,117,89,28,0,0,136,8,2,118,8,75,3,7,51,14,211,11,9,169,22,29,0,33,1,2,28,1,85,0,22,10
Miami Beach Police Department,1993,Florida,92217,FL01307,298,27,271,125,93,32,0,0,88,0,1,76,11,70,5,2,44,19,158,5,3,120,30,24,0,8,1,0,9,0,76,2,8,30
Miami Beach Police Department,1994,Florida,94064,FL01307,309,33,276,125,95,30,0,0,120,0,5,102,13,62,0,3,41,18,182,0,8,143,31,39,0,22,0,0,17,0,74,0,6,24
Miami Beach Police Department,1995,Florida,91529,FL01307,335,32,303,139,93,46,0,0,81,1,1,72,7,82,2,6,68,6,163,3,7,140,13,48,0,2,1,1,16,0,59,0,22,14
Miami Beach Police Department,1998,Florida,96565,FL01307,349,35,314,132,94,38,0,0,78,2,1,69,6,81,0,2,73,6,159,2,3,142,12,45,0,5,4,8,14,0,65,2,6,10
Miami Beach Police Department,1999,Florida,98324,FL01307,367,38,329,152,106,46,0,0,101,1,1,87,12,90,0,1,74,15,191,1,2,161,27,53,1,3,3,0,31,0,77,1,9,13
Miami Beach Police Department,2000,Florida,87933,FL01307,370,36,334,146,109,37,0,0,64,0,1,60,3,112,0,23,85,4,176,0,24,145,7,15,0,15,2,8,17,2,83,6,13,15
Miami Beach Police Department,2001,Florida,90212,FL01307,381,42,339,144,98,46,0,0,82,0,2,71,9,138,1,6,123,8,220,1,8,194,17,50,0,0,7,13,21,1,81,5,23,19
Miami Beach Police Department,2003,Florida,91215,FL01307,366,43,323,143,98,45,0,0,62,0,0,50,12,102,0,1,90,11,164,0,1,140,23,35,0,19,4,0,16,0,65,7,7,11
Miami Beach Police Department,2004,Florida,91296,FL01307,374,43,331,144,101,43,0,0,60,0,2,57,1,133,4,3,115,11,193,4,5,172,12,33,0,25,1,2,19,1,81,2,24,5
Miami Beach Police Department,2005,Florida,91115,FL01307,349,35,314,132,94,38,0,0,89,0,0,83,6,126,1,3,114,8,215,1,3,197,14,30,0,16,3,2,41,0,96,0,15,12
Miami Beach Police Department,2006,Florida,89408,FL01307,386,42,344,153,103,50,0,0,73,0,0,69,4,184,1,8,165,10,257,1,8,234,14,14,0,13,3,0,24,0,153,4,22,24
Miami Beach Police Department,2007,Florida,86742,FL01307,364,39,325,154,110,44,0,0,74,0,0,67,7,146,0,3,137,6,220,0,3,204,13,21,1,6,5,2,29,1,100,1,31,23
Miami Beach Police Department,2008,Florida,83609,FL01307,368,43,325,155,102,53,0,0,75,0,0,74,1,127,2,1,112,12,202,2,1,186,13,22,0,10,4,2,27,0,103,1,19,14
Miami Beach Police Department,2009,Florida,84260,FL01307,365,41,324,147,103,44,0,0,57,0,2,53,2,86,2,1,79,4,143,2,3,132,6,12,0,5,3,3,21,0,57,2,34,6
Miami Beach Police Department,2010,Florida,87779,FL01307,358,42,316,148,99,49,0,0,39,0,0,37,2,72,0,0,69,3,111,0,0,106,5,13,0,11,0,0,15,0,52,2,11,7
Miami Beach Police Department,2011,Florida,88975,FL01307,361,42,319,140,97,43,0,0,25,0,0,24,1,96,2,3,76,15,121,2,3,100,16,48,0,1,0,0,9,0,47,3,9,4
Miami Beach Police Department,2012,Florida,91066,FL01307,372,45,327,128,37,91,0,0,31,0,0,27,4,81,2,0,65,14,112,2,0,92,18,57,0,0,2,0,11,0,29,1,10,2
Miami Beach Police Department,2013,Florida,91433,FL01307,373,45,328,132,94,38,0,0,59,0,0,56,3,71,0,1,61,9,130,0,1,117,12,41,0,1,1,2,8,0,51,0,4,22
Miami Beach Police Department,2014,Florida,91771,FL01307,371,49,322,139,95,44,0,0,19,0,0,14,5,64,0,3,58,3,83,0,3,72,8,29,0,7,0,1,3,3,28,3,3,6
Miami Beach Police Department,2015,Florida,92641,FL01307,371,49,322,139,95,44,0,0,40,0,0,37,3,79,4,1,66,8,119,4,1,103,11,23,0,6,2,0,18,4,48,1,9,8
