agency,year,state,population,ORI,total_officers,female_employees_officers,male_employees_officers,total_civilians,female_employees_civilians,male_employees_civilians,officers_killed_accident,officers_killed_felony,assault_injury_total,assault_injury_gun,assault_injury_knife,assault_injury_hand_feet,assault_injury_other,assault_no_injury_total,assault_no_injury_gun,assault_no_injury_knife,assault_no_injury_hand_feet,assault_no_injury_other,total_assault_total,total_assault_gun,total_assault_knife,total_assault_hand_feet,total_assault_other,all_oth_total_assault,ambush_total_assault,att_oth_arrest_total_assault,burglary_total_assault,civil_disorder_total_assault,cust_prisoners_total_assault,deranged_total_assault,disturbance_total_assault,robbery_total_assault,susp_pers_total_assault,traffic_total_assault
Manatee County Sheriff's Office,1975,Florida,81913,FL04100,133,27,106,1,0,1,0,0,1,0,0,1,0,2,0,0,2,0,3,0,0,3,0,0,0,3,0,0,0,0,0,0,0,0
Manatee County Sheriff's Office,1976,Florida,78946,FL04100,137,29,108,1,0,1,0,0,0,0,0,0,0,1,0,0,0,1,1,0,0,0,1,0,0,1,0,0,0,0,0,0,0,0
Manatee County Sheriff's Office,1977,Florida,84206,FL04100,146,38,108,6,3,3,0,0,0,0,0,0,0,8,0,0,7,1,8,0,0,7,1,2,0,0,0,0,2,0,3,0,0,1
Manatee County Sheriff's Office,1978,Florida,82934,FL04100,102,6,96,73,33,40,0,0,1,0,0,0,1,10,1,1,8,0,11,1,1,8,1,1,0,2,0,0,0,0,7,0,0,1
Manatee County Sheriff's Office,1979,Florida,86183,FL04100,124,12,112,61,30,31,0,0,2,0,0,2,0,5,1,0,4,0,7,1,0,6,0,0,0,1,0,0,2,0,4,0,0,0
Manatee County Sheriff's Office,1980,Florida,98472,FL04100,153,18,135,53,37,16,0,0,1,0,0,1,0,6,1,0,5,0,7,1,0,6,0,0,0,1,0,0,0,0,2,0,1,3
Manatee County Sheriff's Office,1981,Florida,106239,FL04100,269,14,255,43,11,32,0,0,2,0,0,2,0,4,0,0,4,0,6,0,0,6,0,1,0,0,0,0,1,0,3,0,1,0
Manatee County Sheriff's Office,1982,Florida,108852,FL04100,162,11,151,131,63,68,0,0,0,0,0,0,0,0,0,0,0,0,0,0,0,0,0,0,0,0,0,0,0,0,0,0,0,0
Manatee County Sheriff's Office,1983,Florida,111610,FL04100,227,36,191,69,44,25,0,0,0,0,0,0,0,0,0,0,0,0,0,0,0,0,0,0,0,0,0,0,0,0,0,0,0,0
Manatee County Sheriff's Office,1984,Florida,115301,FL04100,159,17,142,153,75,78,0,0,0,0,0,0,0,0,0,0,0,0,0,0,0,0,0,0,0,0,0,0,0,0,0,0,0,0
Manatee County Sheriff's Office,1985,Florida,119668,FL04100,162,12,150,176,89,87,0,0,14,0,1,13,0,8,0,0,7,1,22,0,1,20,1,4,0,0,1,0,1,1,8,0,2,5
Manatee County Sheriff's Office,1986,Florida,122996,FL04100,200,23,177,186,93,93,0,0,6,0,0,6,0,19,0,1,15,3,25,0,1,21,3,4,0,3,0,0,3,1,2,0,6,6
Manatee County Sheriff's Office,1987,Florida,124854,FL04100,223,26,197,254,121,133,0,0,8,0,0,7,1,41,0,0,39,2,49,0,0,46,3,3,0,4,0,0,3,0,27,0,4,8
Manatee County Sheriff's Office,1990,Florida,149718,FL04100,261,35,226,330,159,171,0,0,77,2,1,68,6,25,0,1,21,3,102,2,2,89,9,12,0,22,1,0,3,0,61,0,3,0
Manatee County Sheriff's Office,1991,Florida,153642,FL04100,260,36,224,354,159,195,0,0,74,1,4,56,13,52,1,2,38,11,126,2,6,94,24,5,0,25,0,0,13,0,44,0,2,37
Manatee County Sheriff's Office,1992,Florida,156083,FL04100,269,38,231,358,166,192,0,0,52,2,6,40,4,62,1,4,48,9,114,3,10,88,13,12,1,15,0,0,20,3,36,0,8,19
Manatee County Sheriff's Office,1993,Florida,155490,FL04100,248,33,215,376,175,201,0,0,56,3,4,44,5,67,0,6,46,15,123,3,10,90,20,22,0,26,1,5,16,1,36,0,8,8
Manatee County Sheriff's Office,1994,Florida,158604,FL04100,292,43,249,433,207,226,0,0,43,0,0,40,3,62,1,4,42,15,105,1,4,82,18,15,0,27,1,1,16,1,33,0,4,7
Manatee County Sheriff's Office,1995,Florida,161324,FL04100,295,42,253,433,206,227,0,0,29,0,1,22,6,51,6,2,38,5,80,6,3,60,11,18,0,9,5,1,15,0,22,0,6,4
Manatee County Sheriff's Office,1998,Florida,172812,FL04100,340,41,299,582,291,291,0,0,43,2,4,31,6,61,3,0,45,13,104,5,4,76,19,24,0,25,2,2,13,0,20,0,11,7
Manatee County Sheriff's Office,1999,Florida,175061,FL04100,361,43,318,678,340,338,0,0,14,0,0,13,1,37,5,0,24,8,51,5,0,37,9,10,1,11,1,0,5,0,15,0,1,7
Manatee County Sheriff's Office,2000,Florida,192888,FL04100,358,47,311,590,318,272,0,0,15,1,0,12,2,31,4,0,23,4,46,5,0,35,6,7,0,8,2,1,6,1,8,0,5,8
Manatee County Sheriff's Office,2001,Florida,197886,FL04100,378,54,324,403,267,136,0,0,9,0,0,8,1,44,1,2,38,3,53,1,2,46,4,12,0,10,0,0,6,0,15,0,0,10
Manatee County Sheriff's Office,2002,Florida,201707,FL04100,386,54,332,422,282,140,0,0,9,0,0,9,0,39,0,1,34,4,48,0,1,43,4,8,0,9,0,0,9,0,12,0,2,8
Manatee County Sheriff's Office,2003,Florida,211025,FL04100,642,128,514,316,229,87,0,0,17,0,0,17,0,64,0,1,50,13,81,0,1,67,13,17,0,14,3,1,11,1,21,0,4,9
Manatee County Sheriff's Office,2004,Florida,217203,FL04100,668,136,532,402,275,127,0,0,20,0,2,18,0,53,1,1,46,5,73,1,3,64,5,21,0,2,1,2,7,0,27,0,1,12
Manatee County Sheriff's Office,2005,Florida,225830,FL04100,680,137,543,380,261,119,0,0,17,0,2,15,0,48,1,2,34,11,65,1,4,49,11,22,0,6,1,1,5,0,16,0,4,10
Manatee County Sheriff's Office,2006,Florida,233945,FL04100,647,120,527,357,102,255,0,0,38,1,0,34,3,68,3,1,52,12,106,4,1,86,15,38,0,7,4,2,6,0,31,1,7,10
Manatee County Sheriff's Office,2007,Florida,240279,FL04100,443,61,382,248,189,59,0,0,14,0,0,10,4,57,6,2,30,19,71,6,2,40,23,24,0,2,3,1,3,3,12,3,7,13
Manatee County Sheriff's Office,2008,Florida,241358,FL04100,661,131,530,374,267,107,0,0,17,0,0,16,1,49,0,0,39,10,66,0,0,55,11,24,0,6,1,1,7,1,15,0,3,8
Manatee County Sheriff's Office,2009,Florida,241514,FL04100,468,72,396,375,268,107,0,0,16,0,0,15,1,51,0,1,41,9,67,0,1,56,10,30,0,3,5,1,4,2,13,0,2,7
Manatee County Sheriff's Office,2010,Florida,253276,FL04100,457,63,394,523,276,247,0,0,13,0,0,12,1,54,1,2,44,7,67,1,2,56,8,26,1,5,0,1,8,0,20,2,0,4
Manatee County Sheriff's Office,2011,Florida,256728,FL04100,696,124,572,371,256,115,0,0,16,0,0,16,0,55,1,0,42,12,71,1,0,58,12,23,0,7,2,0,10,0,16,2,5,6
Manatee County Sheriff's Office,2012,Florida,260173,FL04100,472,61,411,592,317,275,0,0,19,0,0,16,3,55,3,0,42,10,74,3,0,58,13,24,0,11,0,0,14,1,14,0,0,10
Manatee County Sheriff's Office,2013,Florida,267132,FL04100,481,62,419,575,312,263,0,0,22,1,0,21,0,64,0,0,52,12,86,1,0,73,12,21,0,7,0,0,17,1,25,0,4,11
Manatee County Sheriff's Office,2014,Florida,276470,FL04100,501,64,437,595,325,270,0,0,12,1,1,10,0,61,4,0,51,6,73,5,1,61,6,12,1,0,0,1,16,4,25,0,3,11
Manatee County Sheriff's Office,2015,Florida,286291,FL04100,737,122,615,348,271,77,0,0,13,0,0,10,3,65,4,0,52,9,78,4,0,62,12,15,0,9,2,1,15,4,19,0,2,11
