agency,year,state,population,ORI,total_officers,female_employees_officers,male_employees_officers,total_civilians,female_employees_civilians,male_employees_civilians,officers_killed_accident,officers_killed_felony,assault_injury_total,assault_injury_gun,assault_injury_knife,assault_injury_hand_feet,assault_injury_other,assault_no_injury_total,assault_no_injury_gun,assault_no_injury_knife,assault_no_injury_hand_feet,assault_no_injury_other,total_assault_total,total_assault_gun,total_assault_knife,total_assault_hand_feet,total_assault_other,all_oth_total_assault,ambush_total_assault,att_oth_arrest_total_assault,burglary_total_assault,civil_disorder_total_assault,cust_prisoners_total_assault,deranged_total_assault,disturbance_total_assault,robbery_total_assault,susp_pers_total_assault,traffic_total_assault
Terre Haute Police,1975,Indiana,67409,IN08401,115,2,113,16,16,0,0,0,0,0,0,0,0,0,0,0,0,0,0,0,0,0,0,0,0,0,0,0,0,0,0,0,0,0
Terre Haute Police,1976,Indiana,66658,IN08401,118,2,116,20,15,5,0,0,0,0,0,0,0,0,0,0,0,0,0,0,0,0,0,0,0,0,0,0,0,0,0,0,0,0
Terre Haute Police,1977,Indiana,72276,IN08401,115,2,113,18,13,5,0,0,0,0,0,0,0,0,0,0,0,0,0,0,0,0,0,0,0,0,0,0,0,0,0,0,0,0
Terre Haute Police,1978,Indiana,63725,IN08401,109,1,108,16,14,2,0,0,0,0,0,0,0,0,0,0,0,0,0,0,0,0,0,0,0,0,0,0,0,0,0,0,0,0
Terre Haute Police,1979,Indiana,64034,IN08401,107,3,104,15,11,4,0,0,0,0,0,0,0,0,0,0,0,0,0,0,0,0,0,0,0,0,0,0,0,0,0,0,0,0
Terre Haute Police,1980,Indiana,61020,IN08401,111,5,106,15,10,5,0,0,0,0,0,0,0,0,0,0,0,0,0,0,0,0,0,0,0,0,0,0,0,0,0,0,0,0
Terre Haute Police,1981,Indiana,61075,IN08401,124,5,119,16,5,11,0,0,0,0,0,0,0,0,0,0,0,0,0,0,0,0,0,0,0,0,0,0,0,0,0,0,0,0
Terre Haute Police,1982,Indiana,61131,IN08401,117,5,112,17,11,6,0,0,0,0,0,0,0,0,0,0,0,0,0,0,0,0,0,0,0,0,0,0,0,0,0,0,0,0
Terre Haute Police,1983,Indiana,61220,IN08401,119,5,114,17,10,7,0,0,1,0,0,1,0,0,0,0,0,0,1,0,0,1,0,0,0,0,0,0,0,0,1,0,0,0
Terre Haute Police,1984,Indiana,60413,IN08401,117,5,112,14,10,4,0,1,19,0,2,16,1,6,0,0,5,1,25,0,2,21,2,1,0,7,0,1,1,0,14,0,1,0
Terre Haute Police,1985,Indiana,60417,IN08401,121,5,116,14,9,5,0,0,7,0,0,6,1,19,0,0,18,1,26,0,0,24,2,3,0,3,0,0,3,0,15,0,0,2
Terre Haute Police,1988,Indiana,57362,IN08401,121,4,117,16,9,7,0,0,11,0,0,11,0,32,0,0,32,0,43,0,0,43,0,1,0,21,1,0,3,0,8,0,3,6
Terre Haute Police,1989,Indiana,56695,IN08401,115,4,111,16,9,7,0,0,1,0,0,1,0,29,0,0,29,0,30,0,0,30,0,1,0,8,0,2,1,0,13,0,0,5
Terre Haute Police,1990,Indiana,57483,IN08401,115,4,111,15,8,7,0,0,4,0,0,3,1,27,0,0,26,1,31,0,0,29,2,0,0,16,0,0,4,0,6,0,4,1
Terre Haute Police,1991,Indiana,58165,IN08401,119,4,115,18,11,7,0,0,7,0,1,6,0,30,0,0,29,1,37,0,1,35,1,0,0,20,0,0,1,0,12,0,1,3
Terre Haute Police,1992,Indiana,58704,IN08401,115,4,111,16,10,6,0,0,7,0,1,6,0,27,0,0,26,1,34,0,1,32,1,0,0,17,0,0,1,0,13,0,1,2
Terre Haute Police,1993,Indiana,59771,IN08401,110,4,106,17,9,8,0,0,0,0,0,0,0,0,0,0,0,0,0,0,0,0,0,0,0,0,0,0,0,0,0,0,0,0
Terre Haute Police,1994,Indiana,60179,IN08401,116,6,110,18,13,5,0,0,0,0,0,0,0,0,0,0,0,0,0,0,0,0,0,0,0,0,0,0,0,0,0,0,0,0
Terre Haute Police,1995,Indiana,60733,IN08401,110,5,105,20,14,6,0,0,0,0,0,0,0,0,0,0,0,0,0,0,0,0,0,0,0,0,0,0,0,0,0,0,0,0
Terre Haute Police,1998,Indiana,54339,IN08401,117,6,111,18,16,2,0,0,3,0,0,3,0,46,1,0,45,0,49,1,0,48,0,5,0,0,1,0,11,0,29,0,2,1
Terre Haute Police,1999,Indiana,53750,IN08401,119,6,113,18,17,1,0,0,10,0,0,8,2,36,0,0,36,0,46,0,0,44,2,5,0,6,1,0,5,1,21,0,1,6
Terre Haute Police,2000,Indiana,59614,IN08401,117,6,111,18,16,2,0,0,2,0,0,2,0,34,0,0,33,1,36,0,0,35,1,2,0,4,0,0,6,0,19,1,0,4
Terre Haute Police,2001,Indiana,59950,IN08401,124,5,119,26,22,4,0,0,4,0,0,4,0,41,0,0,41,0,45,0,0,45,0,3,0,3,2,0,4,0,27,0,1,5
Terre Haute Police,2004,Indiana,58489,IN08401,129,5,124,28,19,9,0,0,2,0,0,2,0,29,0,0,29,0,31,0,0,31,0,5,0,0,0,0,0,0,17,2,2,5
Terre Haute Police,2005,Indiana,57540,IN08401,129,3,126,23,21,2,0,0,4,0,0,4,0,25,0,0,25,0,29,0,0,29,0,3,0,4,0,0,2,1,14,0,3,2
Terre Haute Police,2006,Indiana,57270,IN08401,129,3,126,23,21,2,0,0,6,0,0,6,0,40,0,0,40,0,46,0,0,46,0,5,0,7,1,4,6,0,11,0,5,7
Terre Haute Police,2007,Indiana,56946,IN08401,129,3,126,13,12,1,0,0,5,0,0,5,0,39,0,0,39,0,44,0,0,44,0,7,0,6,1,2,4,0,16,0,3,5
Terre Haute Police,2008,Indiana,58860,IN08401,128,3,125,19,14,5,0,0,4,0,0,4,0,21,0,0,21,0,25,0,0,25,0,3,0,5,1,1,1,2,5,1,1,5
Terre Haute Police,2009,Indiana,60065,IN08401,131,4,127,11,11,0,0,0,4,0,0,4,0,7,0,0,7,0,11,0,0,11,0,5,0,3,0,0,2,0,1,0,0,0
Terre Haute Police,2010,Indiana,60785,IN08401,134,5,129,10,10,0,0,0,1,0,0,1,0,20,0,0,20,0,21,0,0,21,0,6,0,7,0,0,2,2,3,0,0,1
Terre Haute Police,2011,Indiana,61095,IN08401,134,6,128,10,10,0,0,0,0,0,0,0,0,24,0,0,24,0,24,0,0,24,0,8,0,7,0,0,0,3,4,0,1,1
Terre Haute Police,2015,Indiana,60997,IN08401,132,4,128,9,9,0,0,8,11,0,0,10,1,18,0,0,15,3,29,0,0,25,4,8,0,4,0,0,0,2,10,0,3,2
