agency,year,state,population,ORI,total_officers,female_employees_officers,male_employees_officers,total_civilians,female_employees_civilians,male_employees_civilians,officers_killed_accident,officers_killed_felony,assault_injury_total,assault_injury_gun,assault_injury_knife,assault_injury_hand_feet,assault_injury_other,assault_no_injury_total,assault_no_injury_gun,assault_no_injury_knife,assault_no_injury_hand_feet,assault_no_injury_other,total_assault_total,total_assault_gun,total_assault_knife,total_assault_hand_feet,total_assault_other,all_oth_total_assault,ambush_total_assault,att_oth_arrest_total_assault,burglary_total_assault,civil_disorder_total_assault,cust_prisoners_total_assault,deranged_total_assault,disturbance_total_assault,robbery_total_assault,susp_pers_total_assault,traffic_total_assault
Omaha Police Dept,1975,Nebraska,391389,NB02802,571,12,559,125,92,33,0,0,55,5,2,41,7,40,14,5,10,11,95,19,7,51,18,4,0,22,2,0,14,4,32,6,4,7
Omaha Police Dept,1976,Nebraska,388592,NB02802,544,11,533,131,98,33,0,0,57,4,1,42,10,33,12,1,13,7,90,16,2,55,17,7,2,19,0,5,10,2,38,2,4,1
Omaha Police Dept,1977,Nebraska,367281,NB02802,534,12,522,127,94,33,0,0,72,2,0,62,8,45,17,2,19,7,117,19,2,81,15,7,2,31,4,0,14,3,35,4,7,10
Omaha Police Dept,1978,Nebraska,364446,NB02802,550,17,533,127,98,29,0,0,56,0,0,48,8,35,11,2,20,2,91,11,2,68,10,5,0,21,2,0,9,1,42,0,2,9
Omaha Police Dept,1979,Nebraska,370326,NB02802,553,17,536,155,100,55,0,9,74,1,2,56,15,53,7,3,34,9,127,8,5,90,24,6,0,19,1,0,12,4,60,0,7,18
Omaha Police Dept,1980,Nebraska,312919,NB02802,540,14,526,147,95,52,0,0,90,0,1,82,7,88,7,3,70,8,178,7,4,152,15,13,0,40,4,0,15,3,80,0,1,22
Omaha Police Dept,1981,Nebraska,322883,NB02802,556,20,536,136,91,45,0,0,81,0,1,73,7,110,18,3,84,5,191,18,4,157,12,2,0,41,2,0,9,5,82,9,12,29
Omaha Police Dept,1983,Nebraska,327276,NB02802,544,21,523,158,106,52,0,0,80,0,3,70,7,145,8,3,128,6,225,8,6,198,13,8,1,59,2,0,8,4,107,0,6,30
Omaha Police Dept,1984,Nebraska,357790,NB02802,578,29,549,163,101,62,0,0,74,1,0,70,3,203,8,3,177,15,277,9,3,247,18,11,0,65,6,0,9,1,121,1,13,50
Omaha Police Dept,1985,Nebraska,362883,NB02802,574,33,541,164,103,61,0,0,9,0,0,9,0,46,1,0,41,4,55,1,0,50,4,3,0,2,2,0,1,0,31,0,1,15
Omaha Police Dept,1986,Nebraska,332368,NB02802,581,43,538,169,103,66,0,0,0,0,0,0,0,0,0,0,0,0,0,0,0,0,0,0,0,0,0,0,0,0,0,0,0,0
Omaha Police Dept,1988,Nebraska,377958,NB02802,603,52,551,147,99,48,0,0,0,0,0,0,0,0,0,0,0,0,0,0,0,0,0,0,0,0,0,0,0,0,0,0,0,0
Omaha Police Dept,1989,Nebraska,355110,NB02802,631,59,572,148,103,45,0,0,0,0,0,0,0,0,0,0,0,0,0,0,0,0,0,0,0,0,0,0,0,0,0,0,0,0
Omaha Police Dept,1990,Nebraska,335795,NB02802,606,59,547,149,104,45,0,0,0,0,0,0,0,0,0,0,0,0,0,0,0,0,0,0,0,0,0,0,0,0,0,0,0,0
Omaha Police Dept,1994,Nebraska,344975,NB02802,654,100,554,151,115,36,0,0,0,0,0,0,0,0,0,0,0,0,0,0,0,0,0,0,0,0,0,0,0,0,0,0,0,0
Omaha Police Dept,1995,Nebraska,348089,NB02802,673,113,560,158,114,44,0,0,0,0,0,0,0,0,0,0,0,0,0,0,0,0,0,0,0,0,0,0,0,0,0,0,0,0
Omaha Police Dept,1996,Nebraska,350607,NB02802,702,123,579,177,130,47,0,0,0,0,0,0,0,0,0,0,0,0,0,0,0,0,0,0,0,0,0,0,0,0,0,0,0,0
Omaha Police Dept,1997,Nebraska,351745,NB02802,688,126,562,183,135,48,0,0,0,0,0,0,0,0,0,0,0,0,0,0,0,0,0,0,0,0,0,0,0,0,0,0,0,0
Omaha Police Dept,1998,Nebraska,368258,NB02802,703,134,569,182,127,55,0,0,18,0,1,16,1,16,4,3,5,4,34,4,4,21,5,1,0,6,0,0,2,1,15,0,0,9
Omaha Police Dept,1999,Nebraska,372364,NB02802,722,142,580,180,132,48,0,0,36,2,0,32,2,10,1,0,9,0,46,3,0,41,2,1,1,10,0,0,1,1,23,0,4,5
Omaha Police Dept,2000,Nebraska,390007,NB02802,748,148,600,175,132,43,0,0,30,1,1,25,3,12,1,0,8,3,42,2,1,33,6,0,0,10,1,0,5,0,17,1,5,3
Omaha Police Dept,2001,Nebraska,390456,NB02802,717,145,572,190,134,56,0,0,29,2,0,22,5,19,2,0,13,4,48,4,0,35,9,3,0,7,0,0,7,2,20,1,4,4
Omaha Police Dept,2002,Nebraska,394090,NB02802,766,153,613,186,141,45,0,0,16,0,1,12,3,15,0,0,12,3,31,0,1,24,6,1,0,9,0,0,3,1,9,0,5,3
Omaha Police Dept,2003,Nebraska,401692,NB02802,719,140,579,169,139,30,0,1,38,0,0,33,5,21,1,1,16,3,59,1,1,49,8,2,1,10,0,0,3,2,16,0,13,12
Omaha Police Dept,2004,Nebraska,406109,NB02802,751,153,598,171,128,43,0,0,31,0,0,27,4,28,1,3,19,5,59,1,3,46,9,7,0,13,0,1,8,1,19,0,6,4
Omaha Police Dept,2005,Nebraska,412128,NB02802,775,153,622,179,135,44,0,0,31,0,0,30,1,25,1,1,18,5,56,1,1,48,6,2,0,15,0,0,3,3,19,1,6,7
Omaha Police Dept,2006,Nebraska,416770,NB02802,774,150,624,172,126,46,0,0,22,0,0,19,3,21,0,0,20,1,43,0,0,39,4,3,1,10,1,0,2,4,9,0,5,8
Omaha Police Dept,2007,Nebraska,431810,NB02802,755,148,607,165,121,44,0,0,24,0,0,22,2,28,0,0,26,2,52,0,0,48,4,8,1,11,0,1,2,2,16,0,6,5
Omaha Police Dept,2008,Nebraska,437238,NB02802,748,147,601,145,110,35,0,0,38,0,0,32,6,30,1,0,26,3,68,1,0,58,9,12,0,14,0,0,4,1,24,0,8,5
Omaha Police Dept,2009,Nebraska,443037,NB02802,769,145,624,144,109,35,0,0,28,0,0,25,3,15,0,1,13,1,43,0,1,38,4,3,1,6,1,0,1,4,18,1,6,2
Omaha Police Dept,2010,Nebraska,408958,NB02802,789,148,641,129,95,34,0,0,28,1,0,18,9,22,3,0,12,7,50,4,0,30,16,3,0,11,0,0,1,3,13,0,3,16
Omaha Police Dept,2011,Nebraska,412608,NB02802,778,146,632,146,110,36,0,0,38,0,0,33,5,36,0,2,20,14,74,0,2,53,19,5,0,6,0,0,7,2,31,1,9,13
Omaha Police Dept,2012,Nebraska,417970,NB02802,795,149,646,148,110,38,0,0,36,0,0,34,2,24,1,0,15,8,60,1,0,49,10,5,0,13,0,1,5,3,22,0,7,4
Omaha Police Dept,2013,Nebraska,425076,NB02802,767,143,624,134,98,36,0,0,35,0,0,27,8,33,5,0,18,10,68,5,0,45,18,7,1,3,1,1,3,6,31,0,12,3
Omaha Police Dept,2014,Nebraska,438465,NB02802,793,147,646,135,98,37,0,0,33,0,1,29,3,35,0,0,23,12,68,0,1,52,15,4,0,11,0,2,9,2,27,1,9,3
Omaha Police Dept,2015,Nebraska,452252,NB02802,826,151,675,137,97,40,0,1,21,1,0,16,4,23,0,1,14,8,44,1,1,30,12,1,0,5,0,0,0,2,27,0,1,8
