agency,year,state,population,ORI,total_officers,female_employees_officers,male_employees_officers,total_civilians,female_employees_civilians,male_employees_civilians,officers_killed_accident,officers_killed_felony,assault_injury_total,assault_injury_gun,assault_injury_knife,assault_injury_hand_feet,assault_injury_other,assault_no_injury_total,assault_no_injury_gun,assault_no_injury_knife,assault_no_injury_hand_feet,assault_no_injury_other,total_assault_total,total_assault_gun,total_assault_knife,total_assault_hand_feet,total_assault_other,all_oth_total_assault,ambush_total_assault,att_oth_arrest_total_assault,burglary_total_assault,civil_disorder_total_assault,cust_prisoners_total_assault,deranged_total_assault,disturbance_total_assault,robbery_total_assault,susp_pers_total_assault,traffic_total_assault
Fort Worth Police Department,1975,Texas,381275,TX22012,686,12,674,139,71,68,0,1,16,1,1,13,1,1,0,1,0,0,17,1,2,13,1,6,0,4,0,0,1,0,1,1,4,0
Fort Worth Police Department,1976,Texas,364302,TX22012,681,16,665,149,91,58,0,0,23,2,1,19,1,1,1,0,0,0,24,3,1,19,1,7,0,3,0,0,0,0,3,1,6,4
Fort Worth Police Department,1977,Texas,383028,TX22012,671,22,649,205,120,85,2,1,19,3,2,11,3,59,5,1,53,0,78,8,3,64,3,2,0,47,1,0,6,0,13,1,6,2
Fort Worth Police Department,1978,Texas,375860,TX22012,684,29,655,195,117,78,0,1,9,1,1,5,2,54,6,0,47,1,63,7,1,52,3,13,0,23,0,2,1,0,14,1,3,6
Fort Worth Police Department,1979,Texas,384582,TX22012,677,40,637,260,192,68,0,1,43,3,0,37,3,92,17,5,67,3,135,20,5,104,6,40,0,25,1,1,4,4,33,1,14,12
Fort Worth Police Department,1980,Texas,382679,TX22012,692,38,654,189,143,46,0,1,26,3,0,23,0,52,7,4,35,6,78,10,4,58,6,16,0,5,2,1,2,0,31,0,11,10
Fort Worth Police Department,1981,Texas,398482,TX22012,700,50,650,225,131,94,0,0,30,3,3,21,3,51,13,3,29,6,81,16,6,50,9,13,0,2,5,2,9,0,25,5,10,10
Fort Worth Police Department,1982,Texas,412661,TX22012,719,59,660,233,141,92,0,0,22,3,1,16,2,68,7,0,59,2,90,10,1,75,4,11,0,8,0,2,11,0,35,1,14,8
Fort Worth Police Department,1983,Texas,424651,TX22012,774,62,712,336,146,190,0,1,23,0,1,17,5,98,24,7,61,6,121,24,8,78,11,10,0,10,3,1,11,2,47,2,20,15
Fort Worth Police Department,1984,Texas,420050,TX22012,760,74,686,262,191,71,0,0,24,2,0,20,2,94,8,7,69,10,118,10,7,89,12,3,0,18,2,3,17,2,45,0,18,10
Fort Worth Police Department,1985,Texas,424449,TX22012,771,75,696,236,175,61,0,0,47,0,1,36,10,18,5,2,6,5,65,5,3,42,15,3,0,8,5,0,10,1,18,2,9,9
Fort Worth Police Department,1986,Texas,432542,TX22012,853,88,765,273,199,74,0,0,54,2,1,47,4,24,10,2,7,5,78,12,3,54,9,8,0,13,2,0,6,0,22,0,17,10
Fort Worth Police Department,1987,Texas,432305,TX22012,952,119,833,295,212,83,0,0,86,6,0,76,4,24,10,3,2,9,110,16,3,78,13,3,1,17,3,0,3,0,33,6,17,27
Fort Worth Police Department,1988,Texas,432889,TX22012,950,118,832,293,210,83,1,0,88,0,2,77,9,17,9,3,3,2,105,9,5,80,11,3,0,20,3,1,2,1,40,0,13,22
Fort Worth Police Department,1989,Texas,430481,TX22012,981,126,855,304,219,85,0,0,107,1,0,91,15,38,9,4,9,16,145,10,4,100,31,12,0,25,5,0,2,1,57,6,16,21
Fort Worth Police Department,1990,Texas,447619,TX22012,953,120,833,307,214,93,0,0,121,3,2,106,10,51,6,2,30,13,172,9,4,136,23,10,0,26,0,0,4,1,89,3,19,20
Fort Worth Police Department,1991,Texas,457171,TX22012,949,121,828,343,231,112,0,0,108,1,1,92,14,56,19,1,24,12,164,20,2,116,26,21,0,28,4,0,5,1,72,1,8,24
Fort Worth Police Department,1992,Texas,465262,TX22012,1027,135,892,349,239,110,1,0,143,2,1,129,11,68,21,2,28,17,211,23,3,157,28,30,0,51,3,1,6,6,72,2,17,23
Fort Worth Police Department,1993,Texas,463373,TX22012,1074,146,928,316,234,82,1,1,120,3,0,103,14,54,10,3,21,20,174,13,3,124,34,22,0,22,0,0,5,0,74,1,21,29
Fort Worth Police Department,1994,Texas,472288,TX22012,1060,152,908,313,229,84,0,0,72,4,1,63,4,25,12,1,9,3,97,16,2,72,7,7,0,13,0,1,2,0,52,0,12,10
Fort Worth Police Department,1995,Texas,460321,TX22012,1112,166,946,317,234,83,0,0,75,0,2,60,13,27,13,1,5,8,102,13,3,65,21,6,2,16,1,0,1,1,37,2,17,19
Fort Worth Police Department,1996,Texas,470254,TX22012,1166,172,994,313,229,84,0,0,76,0,1,63,12,26,5,3,3,15,102,5,4,66,27,6,0,22,2,0,3,2,35,1,17,14
Fort Worth Police Department,1997,Texas,477900,TX22012,1196,187,1009,328,241,87,0,0,92,1,0,82,9,12,2,1,4,5,104,3,1,86,14,7,0,19,0,0,2,0,33,1,19,23
Fort Worth Police Department,1998,Texas,497830,TX22012,1193,190,1003,317,227,90,0,0,103,1,0,91,11,17,5,1,3,8,120,6,1,94,19,16,0,23,3,0,4,0,49,1,11,13
Fort Worth Police Department,1999,Texas,498883,TX22012,1167,191,976,408,251,157,0,0,108,1,2,83,22,36,3,4,20,9,144,4,6,103,31,21,0,23,2,1,6,2,37,1,21,30
Fort Worth Police Department,2000,Texas,534694,TX22012,1173,196,977,328,233,95,0,0,110,0,0,96,14,92,1,7,74,10,202,1,7,170,24,47,0,18,2,0,3,8,69,0,32,23
Fort Worth Police Department,2001,Texas,546828,TX22012,1222,205,1017,347,248,99,0,0,142,0,2,128,12,111,5,3,97,6,253,5,5,225,18,41,0,20,0,0,2,3,91,6,52,38
Fort Worth Police Department,2002,Texas,558493,TX22012,1243,206,1037,339,244,95,0,0,92,0,0,85,7,82,4,5,59,14,174,4,5,144,21,25,2,11,0,3,3,5,68,0,28,29
Fort Worth Police Department,2003,Texas,576339,TX22012,1263,206,1057,337,237,100,0,0,122,0,0,118,4,101,9,6,84,2,223,9,6,202,6,36,0,17,3,4,8,2,94,0,35,24
Fort Worth Police Department,2004,Texas,594950,TX22012,1307,208,1099,344,240,104,0,0,123,1,0,115,7,125,6,9,100,10,248,7,9,215,17,30,5,14,3,3,1,3,103,1,45,40
Fort Worth Police Department,2005,Texas,613261,TX22012,1342,217,1125,385,251,134,0,1,117,1,0,110,6,86,4,2,68,12,203,5,2,178,18,36,1,10,12,12,8,4,71,0,27,22
Fort Worth Police Department,2006,Texas,641752,TX22012,1368,223,1145,365,255,110,0,0,112,0,0,111,1,74,2,2,66,4,186,2,2,177,5,41,0,17,6,1,3,5,54,2,31,26
Fort Worth Police Department,2007,Texas,670693,TX22012,1412,234,1178,380,274,106,0,0,147,0,0,145,2,121,1,2,113,5,268,1,2,258,7,26,0,28,6,10,11,11,67,2,52,55
Fort Worth Police Department,2008,Texas,701345,TX22012,1486,244,1242,413,300,113,0,0,127,0,0,125,2,100,1,0,93,6,227,1,0,218,8,28,0,33,3,3,3,10,65,3,37,42
Fort Worth Police Department,2009,Texas,723456,TX22012,1502,238,1264,413,114,299,0,0,129,0,0,125,4,96,6,3,79,8,225,6,3,204,12,25,0,19,4,6,11,13,77,0,34,36
Fort Worth Police Department,2010,Texas,741206,TX22012,1505,233,1272,413,292,121,0,0,129,1,3,120,5,65,2,0,50,13,194,3,3,170,18,23,1,19,6,1,2,6,87,5,29,15
Fort Worth Police Department,2011,Texas,756803,TX22012,1509,231,1278,424,290,134,0,0,123,1,0,116,6,82,4,1,66,11,205,5,1,182,17,17,3,20,10,5,8,5,91,7,18,21
Fort Worth Police Department,2012,Texas,770101,TX22012,1536,232,1304,404,276,128,0,0,95,0,0,90,5,63,2,0,53,8,158,2,0,143,13,21,0,6,0,0,1,4,93,0,11,22
Fort Worth Police Department,2015,Texas,829731,TX22012,1557,218,1339,443,285,158,0,0,89,1,1,76,11,40,6,2,18,14,129,7,3,94,25,33,0,33,0,0,6,5,28,2,15,7
