agency,year,state,population,ORI,total_officers,female_employees_officers,male_employees_officers,total_civilians,female_employees_civilians,male_employees_civilians,officers_killed_accident,officers_killed_felony,assault_injury_total,assault_injury_gun,assault_injury_knife,assault_injury_hand_feet,assault_injury_other,assault_no_injury_total,assault_no_injury_gun,assault_no_injury_knife,assault_no_injury_hand_feet,assault_no_injury_other,total_assault_total,total_assault_gun,total_assault_knife,total_assault_hand_feet,total_assault_other,all_oth_total_assault,ambush_total_assault,att_oth_arrest_total_assault,burglary_total_assault,civil_disorder_total_assault,cust_prisoners_total_assault,deranged_total_assault,disturbance_total_assault,robbery_total_assault,susp_pers_total_assault,traffic_total_assault
Staunton Police Department,2016,Virginia,24399,VA12600,46,6,40,16,13,3,0,0,1,0,0,1,0,0,0,0,0,0,1,0,0,1,0,0,0,0,0,0,0,0,0,0,0,1
Staunton Police Department,2015,Virginia,24654,VA12600,48,6,42,16,12,4,0,0,0,0,0,0,0,0,0,0,0,0,0,0,0,0,0,0,0,0,0,0,0,0,0,0,0,0
Staunton Police Department,2014,Virginia,24499,VA12600,48,6,42,16,13,3,0,0,0,0,0,0,0,3,0,0,2,1,3,0,0,2,1,0,0,0,0,2,0,0,0,0,0,1
Staunton Police Department,2013,Virginia,24007,VA12600,51,7,44,15,12,3,0,0,1,0,0,1,0,5,0,0,3,2,6,0,0,4,2,0,0,1,0,0,1,0,1,0,0,3
Staunton Police Department,2012,Virginia,24031,VA12600,48,6,42,15,12,3,0,0,1,0,0,0,1,0,0,0,0,0,1,0,0,0,1,0,0,1,0,0,0,0,0,0,0,0
Staunton Police Department,2011,Virginia,24030,VA12600,51,5,46,16,12,4,0,0,2,0,0,2,0,0,0,0,0,0,2,0,0,2,0,0,0,0,0,0,0,0,0,0,2,0
Staunton Police Department,2010,Virginia,23746,VA12600,44,4,40,14,4,10,0,0,1,0,0,0,1,3,0,0,2,1,4,0,0,2,2,0,0,2,0,1,0,0,0,0,1,0
Staunton Police Department,2009,Virginia,24072,VA12600,49,4,45,15,12,3,0,0,0,0,0,0,0,2,0,0,1,1,2,0,0,1,1,1,0,1,0,0,0,0,0,0,0,0
Staunton Police Department,2008,Virginia,23746,VA12600,53,5,48,16,13,3,0,0,1,0,0,1,0,2,1,0,1,0,3,1,0,2,0,0,0,2,0,0,1,0,0,0,0,0
Staunton Police Department,2007,Virginia,23210,VA12600,53,4,49,16,13,3,0,0,0,0,0,0,0,2,0,0,1,1,2,0,0,1,1,0,0,0,0,0,1,0,1,0,0,0
Staunton Police Department,2006,Virginia,23570,VA12600,52,4,48,15,12,3,0,0,0,0,0,0,0,1,0,1,0,0,1,0,1,0,0,1,0,0,0,0,0,0,0,0,0,0
Staunton Police Department,2005,Virginia,24184,VA12600,49,4,45,11,9,2,0,0,1,0,0,1,0,1,0,0,1,0,2,0,0,2,0,0,0,2,0,0,0,0,0,0,0,0
Staunton Police Department,2004,Virginia,24085,VA12600,49,4,45,16,15,1,0,0,8,0,0,7,1,64,0,0,55,9,72,0,0,62,10,8,0,36,0,0,2,0,13,0,5,8
Staunton Police Department,2003,Virginia,23936,VA12600,47,6,41,15,14,1,0,0,1,0,0,1,0,53,0,0,45,8,54,0,0,46,8,7,0,27,0,0,4,0,9,0,2,5
Staunton Police Department,2002,Virginia,24577,VA12600,49,6,43,16,15,1,0,0,5,0,0,4,1,40,0,1,27,12,45,0,1,31,13,6,0,14,0,0,1,0,12,0,8,4
Staunton Police Department,2001,Virginia,24221,VA12600,47,6,41,17,16,1,0,0,8,0,0,8,0,32,0,0,22,10,40,0,0,30,10,7,0,6,0,0,6,0,12,0,1,8
Staunton Police Department,2e3,Virginia,23853,VA12600,46,7,39,16,11,5,0,0,5,0,0,4,1,43,0,0,31,12,48,0,0,35,13,2,0,17,0,0,0,0,25,0,2,2
Staunton Police Department,1999,Virginia,23626,VA12600,46,6,40,16,12,4,0,0,4,0,0,4,0,43,0,0,37,6,47,0,0,41,6,6,0,17,0,0,2,4,15,0,1,2
Staunton Police Department,1998,Virginia,23524,VA12600,45,4,41,16,12,4,0,0,1,0,0,1,0,52,0,0,50,2,53,0,0,51,2,5,0,23,0,0,0,0,16,0,7,2
Staunton Police Department,1997,Virginia,25529,VA12600,45,5,40,15,12,3,0,0,4,0,0,4,0,35,0,0,35,0,39,0,0,39,0,3,0,26,0,0,0,0,8,0,0,2
Staunton Police Department,1996,Virginia,25306,VA12600,47,4,43,16,15,1,0,0,1,0,0,1,0,35,0,0,35,0,36,0,0,36,0,0,0,12,0,0,0,0,20,0,2,2
Staunton Police Department,1995,Virginia,25090,VA12600,44,4,40,17,13,4,0,0,0,0,0,0,0,47,0,0,46,1,47,0,0,46,1,17,0,13,0,0,0,0,13,0,0,4
Staunton Police Department,1994,Virginia,25231,VA12600,45,4,41,17,15,2,0,0,1,0,0,1,0,27,0,0,27,0,28,0,0,28,0,1,0,21,1,0,0,0,3,0,1,1
Staunton Police Department,1993,Virginia,24997,VA12600,45,4,41,17,16,1,0,0,0,0,0,0,0,57,0,0,55,2,57,0,0,55,2,6,0,20,0,0,2,0,24,0,2,3
Staunton Police Department,1992,Virginia,25209,VA12600,43,3,40,14,13,1,0,0,0,0,0,0,0,52,0,0,52,0,52,0,0,52,0,3,0,20,4,1,0,0,19,0,2,3
Staunton Police Department,1991,Virginia,24850,VA12600,44,3,41,15,13,2,0,0,4,0,0,4,0,77,0,1,76,0,81,0,1,80,0,0,0,22,0,0,1,0,18,0,19,21
Staunton Police Department,1990,Virginia,24461,VA12600,45,3,42,14,13,1,0,0,2,0,0,2,0,84,0,0,84,0,86,0,0,86,0,3,0,37,0,0,3,0,20,0,9,14
Staunton Police Department,1989,Virginia,24836,VA12600,44,3,41,10,8,2,0,0,0,0,0,0,0,41,0,1,40,0,41,0,1,40,0,4,0,16,0,0,1,0,16,0,1,3
Staunton Police Department,1988,Virginia,24781,VA12600,45,2,43,10,8,2,0,0,1,0,0,1,0,18,2,0,14,2,19,2,0,15,2,4,0,7,0,0,0,0,6,0,0,2
Staunton Police Department,1987,Virginia,21936,VA12600,44,3,41,10,8,2,0,0,3,1,0,2,0,11,0,0,9,2,14,1,0,11,2,1,0,2,1,0,0,1,4,0,0,5
Staunton Police Department,1986,Virginia,22457,VA12600,44,5,39,9,7,2,0,0,1,0,0,1,0,7,0,3,4,0,8,0,3,5,0,1,0,3,0,0,0,0,2,0,2,0
Staunton Police Department,1985,Virginia,22176,VA12600,44,5,39,9,8,1,0,0,0,0,0,0,0,3,0,3,0,0,3,0,3,0,0,0,0,0,0,0,0,0,3,0,0,0
Staunton Police Department,1984,Virginia,22669,VA12600,44,4,40,9,8,1,0,0,8,0,1,5,2,4,0,0,4,0,12,0,1,9,2,3,0,4,0,0,1,0,4,0,0,0
Staunton Police Department,1983,Virginia,22704,VA12600,44,4,40,9,9,0,0,0,5,0,0,5,0,27,0,0,27,0,32,0,0,32,0,0,0,13,0,0,7,0,10,0,0,2
Staunton Police Department,1982,Virginia,22463,VA12600,44,2,42,9,8,1,0,0,5,1,0,4,0,12,0,0,12,0,17,1,0,16,0,0,0,5,0,0,6,0,4,0,0,2
Staunton Police Department,1981,Virginia,22197,VA12600,46,3,43,9,8,1,0,0,3,0,0,3,0,9,0,0,8,1,12,0,0,11,1,0,0,3,0,0,2,0,3,0,1,3
Staunton Police Department,1980,Virginia,21777,VA12600,46,3,43,8,8,0,0,0,2,0,0,2,0,3,0,0,3,0,5,0,0,5,0,0,0,0,0,0,2,0,3,0,0,0
Staunton Police Department,1979,Virginia,21503,VA12600,45,4,41,8,8,0,0,0,3,0,0,3,0,3,0,1,2,0,6,0,1,5,0,0,0,0,0,0,0,0,6,0,0,0
Staunton Police Department,1978,Virginia,22336,VA12600,47,4,43,12,12,0,0,0,4,0,0,4,0,1,0,0,1,0,5,0,0,5,0,0,0,0,0,0,2,0,3,0,0,0
Staunton Police Department,1977,Virginia,22746,VA12600,47,2,45,11,11,0,0,0,12,0,0,10,2,1,0,0,1,0,13,0,0,11,2,0,0,10,0,0,1,0,2,0,0,0
Staunton Police Department,1976,Virginia,23931,VA12600,49,1,48,8,7,1,0,0,11,0,0,11,0,1,0,0,1,0,12,0,0,12,0,0,0,12,0,0,0,0,0,0,0,0
Staunton Police Department,1975,Virginia,22472,VA12600,48,1,47,8,6,2,0,0,2,0,0,1,1,0,0,0,0,0,2,0,0,1,1,0,0,1,0,0,1,0,0,0,0,0
